15 20 6
..##################
........#.......#S.#
#.#####.#.#####.#.##
#.#S..........#....#
#.#.#########.####.#
#...#.......#......#
#####.##S##.#.######
#.....#...#...#....#
#.#####.#.#####.##.#
#.#S....#.......#..#
#.#.#############.##
#..................#
########.##S########
#S................S#
####################