12 12 8
.S..........
###.##.##.##
.S..#...S..#
.##.#.##.#..
...S...##...
.##.###.##.#
.S.....S....
###.##.##.##
...#...#....
.#.#.##.#.##
..S......S..
....#.......