7 10 8
.S..#..S..
..#.#.#.#.
.#.S....#S
#.##.#S...
....#.#.#.
S.#....S..
...#.S....