12 12 15
..S.S.S.S...
#.#.#.#.#.#.
............
.#.#.#.#.#.#
............
.#.#.#.#.#.#
............
.#.#.#.#.#.#
............
.#.#.#.#.#.#
.S.S.S.S.S..
S#S#S#S#S#S#