10 15 4
..#############
....#.....#S..#
#.#.#.###.#.#.#
#.#.........#.#
#.###########.#
#.............#
#.####.########
#S#.........#S#
#.#.#######.#.#
#......S......#