5 8 6
..S..S..
.#.#..#S
..#S#...
S....#S.
.#..#...